#####################
P #         #      P#
# # # ##### # # ### #
#   # #   #   # #   #
# # # # # ##### # ###
# # # # # #     #   #
# # # # # # # ### ###
# #   # # # #   #   #
# ## ## #   # ##### #
#         # #       #
# ##### ### ##### # #
#       #   # #   # #
# ####### ### # ### #
#   #       #     # #
### # # ### ## ## # #
#   # #   # #   #   #
# ### # ### # # ### #
#   # # #     # # # #
### # # # ##### # # #
#P    #   #     #  P#
#####################