#####################
E #C#       #       #
# # # ##### # # ### #
#   # #   #   # #   #
# # # # # ##### # ###
# # # # # #     #   #
# # # # # # # ### ###
# #   # # # #  C#   #
# ## ## #   # ##### #
#       # # #       #
# ##### ### ##### # #
#       #   # #   # #
# ####### ### # ### #
#   #   #   #     # #
### # # ### ## ## ###
#   # #  C# #   #   #
# ### # ### # # ### #
#   # # #     # # # #
### # # # ##### # # #
#     #   #     #  P#
#####################